0000000000F0F0F0F00000000000000000000000
00F0F0F0F0F0F0F0W0F0F0F0F000000000000000
00F0W0F0F0F0F0B2F0F000000000000000000000
00F0F0F0B2W0F0P0F0T1T1T1E000000000000000
0000W0F0F0F0B2F0F0F00000F000000000000000
0000000000000000F0F0F0W0F000000000000000
0000000000000000000000000000000000000000
0000000000000000000000000000000000000000
0000000000000000000000000000000000000000
0000000000000000000000000000000000000000
0000000000000000000000000000000000000000
0000000000000000000000000000000000000000
0000000000000000000000000000000000000000
0000000000000000000000000000000000000000
0000000000000000000000000000000000000000
0000000000000000000000000000000000000000
0000000000000000000000000000000000000000
0000000000000000000000000000000000000000
0000000000000000000000000000000000000000
0000000000000000000000000000000000000000
