1
00000000F0F0F00000
00F000F0F0P0B30000
00F0F0B1F0F0T1T1E0
F0F0B1F0B2F0000000
00F0F000F0F0F00000
