1
000000000000F0F0F000000000
00F0F0F0F0F0F0W0F0F0F0F0F0
00F0F0W0F0F0F0F0F0F0F0F0T1
00F0F0F0F0F0P0F0F0F0F0W0E0
0000F0S1F0F0F0F0W0F0F0W0W0
000000F000F0F0F0F0F0F00000
