0000000000000000000000000000000000000000
000000000000F0F0F00000000000000000000000
00F0F0F0F0F0F0W0F0F0F0F0F000000000000000
00F0F0W0F0F0F0F0F0F0F0F0T100000000000000
00F0F0F0F0F0P0F0F0F0F0W0E000000000000000
0000F0S0F0F0F0F0W0F0F0W0W000000000000000
000000F000F0F0F0F0F0F0000000000000000000
0000000000000000000000000000000000000000
0000000000000000000000000000000000000000
0000000000000000000000000000000000000000
0000000000000000000000000000000000000000
0000000000000000000000000000000000000000
0000000000000000000000000000000000000000
0000000000000000000000000000000000000000
0000000000000000000000000000000000000000
0000000000000000000000000000000000000000
0000000000000000000000000000000000000000
0000000000000000000000000000000000000000
0000000000000000000000000000000000000000
0000000000000000000000000000000000000000
