00000000000000000000F0F00000000000000000
000000E0T1T1T1G0G0G0F0F00000000000000000
00000000F0F0F0F0F0F0F0F0F000000000000000
000000000000F0F0F0F0F0F0F000000000000000
000000000000F000F0F0F0F00000000000000000
000000000000F0F0F0F0F0F0S1F0F0F000000000
0000000000000000F0F0F0F0F0F0F0F000000000
0000000000000000F0P0F0F0F000F0S100000000
0000000000000000F0F0F0F0F0F0F0F0F0000000
0000000000000000B1F0F0F0F0F0F0F0F0000000
0000000000000000F0H000000000000000000000
0000000000000000000000000000000000000000
0000000000000000000000000000000000000000
0000000000000000000000000000000000000000
0000000000000000000000000000000000000000
0000000000000000000000000000000000000000
0000000000000000000000000000000000000000
0000000000000000000000000000000000000000
0000000000000000000000000000000000000000
0000000000000000000000000000000000000000
