1
E0B1B1F0F0F0F0F000
T1F0B1B1T1B1B1B1F0
T1B1B1F0B1B1F0B1B1
F0B1F0B1F0B1B1B1F0
B1F0B1F0B1P0B1B1E0
F0B1B1F0B1B1B1T1T1
00F0F0B1B1F0F0B1F0

