0000000000000000000000000000000000000000
00000000E0B1B1F0F0F0F0F00000000000000000
00000000T1F0B1B1T1B1B1B1F000000000000000
00000000T1B1B1F0B1B1F0B1B100000000000000
00000000F0B1F0B1F0B1B1B1F000000000000000
00000000B1F0B1F0B1P0B1B1E000000000000000
00000000F0B1B1F0B1B1B1T1T100000000000000
0000000000F0F0B1B1F0F0B1F000000000000000
0000000000000000000000000000000000000000
0000000000000000000000000000000000000000
0000000000000000000000000000000000000000
0000000000000000000000000000000000000000
0000000000000000000000000000000000000000
0000000000000000000000000000000000000000
0000000000000000000000000000000000000000
0000000000000000000000000000000000000000
0000000000000000000000000000000000000000
0000000000000000000000000000000000000000
0000000000000000000000000000000000000000
0000000000000000000000000000000000000000
