0000000000000000F0F0F0F0F000000000000000
0000E0T1T1T1T1T1F0F0W0B2F000000000000000
0000000000000000F0B2B2F0F000000000000000
0000000000000000F0F0B2B2F000000000000000
000000000000000000F0F0F0F000000000000000
000000000000000000F0P0F0F000000000000000
0000000000000000000000000000000000000000
0000000000000000000000000000000000000000
0000000000000000000000000000000000000000
0000000000000000000000000000000000000000
0000000000000000000000000000000000000000
0000000000000000000000000000000000000000
0000000000000000000000000000000000000000
0000000000000000000000000000000000000000
0000000000000000000000000000000000000000
0000000000000000000000000000000000000000
0000000000000000000000000000000000000000
0000000000000000000000000000000000000000
0000000000000000000000000000000000000000
0000000000000000000000000000000000000000
