1
000000000000F0F0F0F0F0
E0T1T1T1T1T1F0F0W0B2F0
000000000000F0B2B2F0F0
000000000000F0F0B2B2F0
00000000000000F0F0F0F0
00000000000000F0P0F0F0

