000000000000F0F0F0F000000000000000000000
0000000000F0F0F0P0F0F0000000000000000000
0000000000F0F0I0I0I0I0B1F000000000000000
0000000000F0G0T100F0F0F0F000000000000000
00000000000000F000000000F000000000000000
00000000000000F0000000000000000000000000
00000000000000F0F00000000000000000000000
0000000000F0F0S0F0F000000000000000000000
0000000000F0F0F0F0F0T1E00000000000000000
00000000F0F0B1G0F0F0F0000000000000000000
0000000000000000000000000000000000000000
0000000000000000000000000000000000000000
0000000000000000000000000000000000000000
0000000000000000000000000000000000000000
0000000000000000000000000000000000000000
0000000000000000000000000000000000000000
0000000000000000000000000000000000000000
0000000000000000000000000000000000000000
0000000000000000000000000000000000000000
0000000000000000000000000000000000000000
