1
0000F0F0F0F0000000
00F0F0F0P0F0F00000
00F0F0I0I0I0I0B1F0
00F0G0T100F0F0F0F0
000000F000000000F0
000000F00000000000
000000F0F000000000
00F0F0S1F0F0000000
00F0F0F0F0F0T1E000
F0F0B1G0F0F0F00000
