0000000000000000000000000000000000000000
0000F0F0F0F000000000F0F00000F00000000000
00F0F0F0P0F0F0F0F0F0F0F00000F00000000000
00F0F0C0F0F0F0T1F0F0F0F00000F0F0F0000000
000000F0F0T1F0B9I0I0I0I0T1B4F0F0F0E00000
0000000000F0F0T1F0F0G0F00000F0F000000000
000000000000F0F0S0F0F0F00000000000000000
000000000000F0F0F0F0F0F0F000000000000000
000000000000F0F0F0F0F0000000000000000000
000000000000F0F0F0F000000000000000000000
0000000000000000000000000000000000000000
0000000000000000000000000000000000000000
0000000000000000000000000000000000000000
0000000000000000000000000000000000000000
0000000000000000000000000000000000000000
0000000000000000000000000000000000000000
0000000000000000000000000000000000000000
0000000000000000000000000000000000000000
0000000000000000000000000000000000000000
0000000000000000000000000000000000000000
