00000000000000000000F0000000000000000000
000000000000E0000000I0000000000000000000
000000000000T1T1T1F0I0F0F000000000000000
00000000000000000000I0I0F000000000000000
000000000000P1F0F0F0I0T1F0F0F0T1B1000000
000000000000F0F0F0F0B1G0F0F0F0F0F0000000
000000000000000000F0F000F0T1F0F0B1000000
000000000000000000F0P000F0F00000F0000000
000000000000000000F0F0F0B1F0F000F0F00000
000000000000000000000000F0F0F0F0F0F00000
000000000000000000000000F0F000F0F0F00000
0000000000000000000000000000000000000000
0000000000000000000000000000000000000000
0000000000000000000000000000000000000000
0000000000000000000000000000000000000000
0000000000000000000000000000000000000000
0000000000000000000000000000000000000000
0000000000000000000000000000000000000000
0000000000000000000000000000000000000000
0000000000000000000000000000000000000000
