1
00000000F000000000000000
E0000000I000000000000000
T1T1T1F0I0F0F00000000000
00000000I0I0F00000000000
P1F0F0F0I0T1F0F0F0T1B100
F0F0F0F0B1G0F0F0F0F0F000
000000F0F000F0T1F0F0B100
000000F0P000F0F00000F000
000000F0F0F0B1F0F000F0F0
000000000000F0F0F0F0F0F0
000000000000F0F000F0F0F0
