1
F0F0F0F0F0000000000000000000000000000000
F0B1F0F0F0F0T2T2T2F0W700000000000000F0F0
000000F0F0T2I0I0T2I0I0I0F0P0F0F0F0F0F0T2
000000F0B3T2I0I0T2I0I0I0F0F0F0F0F0F0F0F0
000000F0F0F0T2T2T2F0F00000000000000000F0
00000000000000000000000000000000000000F0
00000000000000000000000000000000000000T1
00000000000000000000000000000000000000E0
