1
00F0F0F000000000000000
F0F0F0F0F000F0T4F00000
F0F0T0F0F000F0F0F00000
F0B1F0P0F000F0F0T1F0E0
00F0F0F000000000000000
