0000000000000000000000000000000000000000
00000000000000F0F0F0F0F0F000000000000000
00000000F000W8F0F0F0F0S4F000000000000000
0000F0B1F0W8W8F0F0F0B1F0F0F0000000000000
0000F0F0W2W8W8W8F0F0F0F0E1W9000000000000
0000F0F0F0P0W8W8W8F0F0W9W9W9W9W9F0000000
000000F0F0S1W8W800F0W9W9W9W9W9F0F0000000
00000000F0F0F0F000000000F0W9W9F0F0000000
00000000F0F0F00000000000F0F0F0F0F0000000
000000000000000000000000000000F0E0000000
0000000000000000000000000000000000000000
0000000000000000000000000000000000000000
0000000000000000000000000000000000000000
0000000000000000000000000000000000000000
0000000000000000000000000000000000000000
0000000000000000000000000000000000000000
0000000000000000000000000000000000000000
0000000000000000000000000000000000000000
0000000000000000000000000000000000000000
0000000000000000000000000000000000000000
