1
E000F0F0F0F0F0F0
T1E1F0T3F0E1F0F0
0000F0F0T4F0F0F0
0000F0F0F0F0F0F0
0000000000B20000
0000F0P0F0F00000
