000000000000F0F0F0F000000000000000000000
00F0F0F0F000F0F000F000000000F0F000000000
F0F0F0F0F0F0B2F0F0F0F0F0F000F0F00000F0F0
F0F0F0F000F0F0F0F0F0F0F0F000F0F0F0F0F0F0
00F0F0F000F0F00000F0F0F0B2D0F0F0F0B1F0F0
0000F0F0F0B1F0F0F0F0F0F00000F0F0F0F0F0F0
00000000000000000000F0F0F000000000F0F0T2
0000F0F000F000F00000000000O0F0F000F0M6M6
0000F0E0F0F0D0F0F0F0F0F0F0F0F0F0D0T1M6M6
000000F0F00000F0F0F0F0F0F0F0F0F000H0M600
0000000000000000000000000000000000000000
0000000000000000000000000000000000000000
0000000000000000000000000000000000000000
0000000000000000000000000000000000000000
0000000000000000000000000000000000000000
0000000000000000000000000000000000000000
0000000000000000000000000000000000000000
0000000000000000000000000000000000000000
0000000000000000000000000000000000000000
0000000000000000000000000000000000000000
