1
F0F0F0F0F0000000
F0F0F0F0F0F0G0F000
B1F0P1P0G0F0F0B1
F0F0F0F0F0F0F0F0
F0F0F0F0F0000000
F0F0F0F000000000
