1
F0F0F0F0F0F0F0E00000000000000000
F0P0F0F0F0F0F0F0000000F0F0F0F000
F0F0F0F0F0F0F0F0000000F0F0F0E000
F0F0F0F0F0F0F0F0000000F0F0F0F000
F0F0F0F0F0F0F0F0000000P0F0F0F000
