0000000000000000000000000000000000000000
0000000000000000000000F0F0F0F0F0F0C00000
000000000000F0F0F0F0F0F0F0F0F00000C00000
000000000000F0F0F0B0F0F00000F00000C00000
000000000000F0F0B0P0F0F00000F000F0C00000
00000000000000F0F0F0F0F0F0F0F000F0000000
0000000000000000F0F0B0F0F0B0F0F000000000
000000000000000000F0R00000R0F00000000000
00000000000000000000R00000R0000000000000
00000000000000000000F0F0F0F0F0E000000000
0000000000000000000000000000000000000000
0000000000000000000000000000000000000000
0000000000000000000000000000000000000000
0000000000000000000000000000000000000000
0000000000000000000000000000000000000000
0000000000000000000000000000000000000000
0000000000000000000000000000000000000000
0000000000000000000000000000000000000000
0000000000000000000000000000000000000000
0000000000000000000000000000000000000000
